108,118,60,50,90,200
116,137,140,40,130,310
122,131,110,70,90,270
128,146,180,60,150,390
134,140,55,30,55,140
139,148,190,60,150,400
143,152,70,40,60,170
150,160,70,50,90,210
158,168,60,30,60,150
166,174,90,50,80,220
171,180,90,50,60,200
